6 10 4 5
##########
#    ##  #
# ##    ##
#  #### ##
# # #    #
##########